rn;base_2020;base_2021;base_2022;base_all;k_2020;k_2021;k_2022;k_all
45;0.608064516;0.603478261;0.605263158;0.605890411;31;23;19;73
0;0.699848661;0.702917413;0.696703614;0.700352394;6872;7253;4150;18275
5;0.582544932;0.573090024;0.558326217;0.572106515;1391;1644;1171;4206
267;0.643787879;0.66624;0.628040201;0.647265077;264;250;199;713
14;0.786845638;0.820315789;0.803832335;0.805019763;149;190;167;506
44;0.755454545;0.748888889;0.726933333;0.746;121;99;75;295
190;0.668214286;0.64;0.605625;0.642666667;28;46;16;90
114;0.720666667;0.7045;0.663636364;0.705081967;30;20;11;61
84;0.733461538;0.75;0.730769231;0.737857143;26;17;13;56
41;0.86;0.893058824;0.842765957;0.864817814;68;85;94;247
214;0.769333333;0.594705882;0.104054054;0.414069767;15;34;37;86
249;0.6625;0.677857143;0.6;0.667;4;14;2;20
169;0.669827586;0.734418605;0.718636364;0.701138211;58;43;22;123
4;;0.54;;0.54;0;1;0;1
10;0.820150659;0.815130719;0.843998145;0.830342188;531;612;1078;2221
164;0.790909091;0.779444444;0.781904762;0.783;11;18;21;50
275;0.683454075;0.704083969;0.729796334;0.702647059;773;1048;491;2312
145;0.67786645;0.681424936;0.661066667;0.674737662;614;786;525;1925
172;0.669;0.673;0.703571429;0.684411765;10;10;14;34
111;0.705190311;0.696546763;0.737962963;0.705110565;289;417;108;814
255;0.739924718;0.743102767;0.660983982;0.721022989;797;506;437;1740
134;0.783636364;0.819411765;0.7790625;0.790140845;22;17;32;71
171;0.593333333;0.687777778;0.614;0.644864865;9;18;10;37
143;0.802857143;0.831097561;0.837428571;0.822444444;63;82;35;180
51;0.641519435;0.636618076;0.634133333;0.637591069;283;343;225;851
264;0.563333333;0.7;0.69;0.673;3;4;13;20
115;0.6725;0.673225806;0.626956522;0.662830189;52;31;23;106
125;0.644090909;0.6485;0.622714286;0.640611511;88;120;70;278
129;0.852111111;0.808115942;0.865;0.838376963;90;69;32;191
140;0.723428571;0.630677966;0.5716;0.632708333;35;59;50;144
35;0.70106383;0.678908297;0.64;0.678086957;141;229;90;460
279;0.726069652;0.759345794;0.82510917;0.77234472;201;214;229;644
113;0.809090909;;;0.809090909;33;0;0;33
187;0.698;0.74;0.663478261;0.709365079;50;53;23;126
175;0.776969697;0.747826087;0.83;0.774141414;33;46;20;99
234;0.700208333;0.716666667;0.761851852;0.720761905;48;30;27;105
178;0.649259259;0.666764706;0.663181818;0.660120482;27;34;22;83
107;0.753653846;0.759012346;0.781300813;0.763333333;156;162;123;441
152;0.700483871;0.696949153;0.653559322;0.687154812;62;118;59;239
157;0.72173913;0.68;0.727173913;0.707747253;69;67;46;182
206;0.732152318;0.701222076;0.705988858;0.713051044;604;761;359;1724
201;0.723012048;0.706751592;0.687248322;0.706422893;166;314;149;629
223;0.7035;0.699545455;0.654444444;0.693137255;20;22;9;51
239;0.688095238;0.545238095;0.545151515;0.576458333;21;42;33;96
120;0.700454545;0.69202381;0.708653846;0.699196429;88;84;52;224
166;0.617272727;0.736956522;0.746;0.715925926;11;23;20;54
235;0.776818182;0.697142857;0.72;0.731896552;44;49;23;116
108;0.702142857;0.691949153;0.7464;0.707295918;28;118;50;196
244;0.707058824;0.731290323;0.727272727;0.719868421;34;31;11;76
165;0.742083333;0.74862069;0.7255;0.740618557;48;29;20;97
183;0.741621622;0.720068493;0.787015707;0.755060827;74;146;191;411
89;0.652777778;0.635555556;0.62875;0.646226415;36;9;8;53
63;0.81875;0.804264706;0.804761905;0.809277108;56;68;42;166
139;0.725454545;0.737538462;0.705;0.7255;77;65;38;180
217;0.8075;0.77;;0.7825;4;8;0;12
1;0.505;0.705;0.831428571;0.710666667;4;4;7;15
42;0.865;0.852;0.98;0.931666667;2;5;11;18
78;0.717264574;0.739959016;0.71877551;0.726644951;223;244;147;614
237;0.617647059;0.653823529;0.771;0.653076923;34;34;10;78
158;0.646060606;0.721612903;0.557;0.665675676;33;31;10;74
219;0.691639344;0.687901235;0.712758621;0.693450292;61;81;29;171
144;0.826266667;0.715666667;0.767741935;0.788529412;75;30;31;136
27;0.874497041;0.85766129;0.932741935;0.878788732;169;124;62;355
12;0.67;0.730535714;0.697777778;0.722753623;4;56;9;69
40;0.795;0.723333333;0.815555556;0.77244898;22;18;9;49
34;0.622647059;0.63875;0.602222222;0.622258065;34;32;27;93
57;0.568;0.7475;0.67;0.6868;5;12;8;25
75;0.853235294;0.820619469;0.9375;0.866037736;68;113;84;265
149;0.638;0.662424242;0.598;0.644487179;75;66;15;156
240;0.694642857;0.589787234;0.694210526;0.64212766;28;47;19;94
28;;0.75;0.745;0.746363636;0;3;8;11
94;0.535333333;0.649791667;0.5955;0.603673469;30;48;20;98
232;0.622666667;0.609411765;0.572222222;0.610273973;30;34;9;73
195;;;;;0;0;0;0
88;0.731219512;0.706404494;0.673125;0.703146067;41;89;48;178
220;0.7015;0.768695652;0.776;0.744716981;20;23;10;53
64;0.44;0.681025641;0.5775;0.661111111;2;39;4;45
247;;;0.72;0.72;0;0;16;16
90;0.777857143;0.574;0.62;0.71;14;5;3;22
122;0.429;0.617;0.577272727;0.542258065;10;10;11;31
181;0.536;0.727;0.784545455;0.735405405;5;10;22;37
104;0.802580645;0.701052632;0.69125;0.753965517;31;19;8;58
98;0.69;0.723333333;0.826666667;0.736363636;5;3;3;11
52;0.661186441;0.647619048;0.653714286;0.655073529;59;42;35;136
11;0.78;0.655;0.6225;0.639411765;1;4;12;17
9;0.88;;0.91;0.895;1;0;1;2
198;0.805483871;0.793333333;0.9;0.828333333;31;33;26;90
47;0.526470588;0.788571429;0.6;0.655306122;17;21;11;49
151;0.662857143;0.72625;0.826666667;0.733809524;7;8;6;21
271;0.804166667;0.734074074;0.753333333;0.755;12;27;15;54
230;0.756;0.790625;0.7824;0.778961039;20;32;25;77
168;0.77;0.628333333;0.43;0.614166667;3;6;3;12
61;0.846666667;0.792857143;0.936666667;0.908913043;3;7;36;46
159;0.771818182;;0.911;0.838095238;11;0;10;21
101;0.757254902;0.75;;0.756981132;51;2;0;53
208;0.794666667;0.610769231;0.678571429;0.703142857;15;13;7;35
231;0.59375;0.57;0.552307692;0.568918919;8;16;13;37
184;0.736666667;0.502222222;0.616153846;0.605357143;6;9;13;28
200;0.724411765;0.607246377;0.683333333;0.650677966;34;69;15;118
182;;0.575555556;0.747142857;0.650625;0;9;7;16
121;0.692;0.498571429;0.58375;0.581;5;7;8;20
25;0.896428571;0.81;0.849615385;0.849491525;42;50;26;118
138;0.676785714;0.655;0.65;0.673030303;28;2;3;33
193;0.687678571;0.68875;0.690217391;0.688797468;56;56;46;158
81;0.7836;0.787272727;0.698333333;0.772380952;25;11;6;42
204;0.812222222;0.612857143;0.765;0.757037037;18;7;2;27
167;;;;;0;0;0;0
123;0.672;0.685333333;0.689333333;0.685142857;5;15;15;35
284;0.557391304;0.572222222;0.596842105;0.573846154;23;36;19;78
283;0.722857143;0.717272727;0.7;0.715217391;7;11;5;23
254;0.693333333;0.712105263;0.789117647;0.728157895;42;38;34;114
142;;;;;0;0;0;0
222;0.711219512;0.833404255;0.759375;0.773846154;41;47;16;104
258;0.632222222;0.621714286;0.513333333;0.597710843;27;35;21;83
268;0.787142857;;0.82;0.79125;7;0;1;8
146;0.665909091;0.744210526;0.72875;0.706530612;22;19;8;49
221;0.519375;0.452888889;0.572222222;0.494705882;48;45;9;102
49;0.648823529;0.625675676;0.568125;0.618142857;17;37;16;70
29;0.546666667;0.695;0.98;0.623148148;30;22;2;54
100;0.726666667;;;0.726666667;12;0;0;12
141;0.688;0.5525;0.524166667;0.582352941;10;12;12;34
13;0.778846154;0.725625;0.716666667;0.751176471;26;16;9;51
262;;0.865;0.836666667;0.852857143;0;4;3;7
163;0.911935484;0.860789474;0.859130435;0.877608696;31;38;23;92
245;0.663529412;0.67;0.66;0.663076923;17;2;7;26
266;0.88;0.43;0.54;0.616666667;2;2;2;6
229;0.88;;;0.88;1;0;0;1
137;0.563333333;0.748823529;0.738333333;0.725;3;17;6;26
282;0.752564103;0.717916667;0.751086957;0.739548872;39;48;46;133
259;0.88;0.773333333;0.865;0.805555556;1;6;2;9
131;0.816;0.880526316;0.744;0.845862069;5;19;5;29
209;0.73125;0.627727273;0.605555556;0.643846154;8;22;9;39
186;0.855;0.718648649;0.895;0.739534884;4;37;2;43
43;0.95;0.924;0.903333333;0.923846154;7;10;9;26
58;;0.79;;0.79;0;4;0;4
263;0.587428571;0.607291667;0.623125;0.602828283;35;48;16;99
197;0.804285714;0.6775;0.98;0.776666667;7;4;1;12
188;0.575;0.54;0.563333333;0.56;2;2;3;7
241;;0.42;;0.42;0;1;0;1
96;0.648235294;0.633181818;0.633636364;0.637540984;17;22;22;61
194;0.98;0.605;0.458;0.59;1;18;5;24
210;0.677857143;0.565714286;0.785;0.6421875;14;14;4;32
238;0.547;0.93;0.67;0.615384615;10;2;1;13
76;0.86;0.98;;0.894285714;10;4;0;14
46;0.753333333;0.5825;0.72;0.648571429;6;16;6;28
257;0.679333333;0.741428571;0.7325;0.712121212;15;14;4;33
196;0.684166667;0.821818182;0.55;0.7225;24;11;1;36
180;0.83;0.586666667;0.65;0.71625;4;3;1;8
199;0.71;0.670740741;0.741333333;0.701449275;27;27;15;69
281;0.826;0.725714286;0.645;0.726666667;5;7;6;18
252;0.668571429;0.55;0.708;0.65125;7;4;5;16
56;0.720344828;0.791351351;0.836666667;0.763478261;29;37;3;69
109;0.701538462;0.77;;0.714375;13;3;0;16
228;;;;;0;0;0;0
246;0.802142857;0.7275;0.747777778;0.754615385;14;20;18;52
87;0.62875;0.714;0.748571429;0.6964;8;10;7;25
154;0.685555556;;;0.685555556;9;0;0;9
62;0.98;0.626363636;;0.655833333;2;22;0;24
278;0.79;0.767058824;0.478333333;0.725428571;12;17;6;35
71;;0.72;0.91;0.737272727;0;10;1;11
66;;;0.759;0.759;0;0;20;20
256;0.5425;0.676;0.598461538;0.605909091;4;5;13;22
24;0.744615385;0.684285714;0.58;0.699583333;13;7;4;24
50;0.685714286;0.660416667;0.663684211;0.6696875;21;24;19;64
48;0.762;0.6975;0.576666667;0.676315789;5;8;6;19
216;0.666666667;0.758095238;0.787142857;0.730930233;15;21;7;43
97;0.659354839;0.635555556;0.635454545;0.64475;31;27;22;80
68;;0.65;0.945333333;0.896111111;0;3;15;18
31;0.7075;0.727777778;0.765;0.724642857;8;18;2;28
276;0.55;;;0.55;11;0;0;11
179;0.690263158;0.702692308;0.725;0.70125;38;26;16;80
103;0.78;0.78;0.78;0.78;5;11;9;25
32;0.68;0.44;;0.5;1;3;0;4
132;;;0.659666667;0.659666667;0;0;30;30
174;0.805;0.768;0.78;0.783636364;4;5;2;11
54;0.629375;0.548888889;0.525;0.59;16;9;4;29
53;0.611515152;0.615714286;0.685555556;0.622714286;33;28;9;70
148;0.69;0.645;0.62;0.665384615;7;4;2;13
274;0.75;0.560344828;0.75;0.578125;1;29;2;32
112;0.78;;;0.78;1;0;0;1
272;0.827142857;0.685294118;0.546;0.721111111;14;17;5;36
37;0.579;0.591875;0.58;0.586206897;10;16;3;29
170;0.75;0.724285714;0.62;0.667777778;1;7;10;18
92;0.625;0.442777778;0.512;0.482592593;4;18;5;27
224;;0.78;;0.78;0;1;0;1
21;0.638333333;0.694782609;0.720588235;0.696956522;6;23;17;46
202;0.62375;0.607777778;0.576666667;0.599310345;8;9;12;29
218;0.6625;0.535;0.59;0.6125;4;2;2;8
70;0.72;0.72;0.88;0.816;2;2;6;10
91;0.5475;0.71;0.139;0.392;4;6;10;20
23;;;0.98;0.98;0;0;11;11
36;0.627;0.525294118;0.592857143;0.569117647;10;17;7;34
270;0.693333333;0.748333333;0.841428571;0.77875;3;6;7;16
227;0.648181818;0.582727273;0.44;0.607826087;11;11;1;23
80;0.98;0.86;;0.92;1;1;0;2
22;;0.65;0.75;0.742307692;0;1;12;13
69;;;0.887692308;0.887692308;0;0;26;26
189;0.7;0.59;0.612;0.641071429;12;11;5;28
126;0.597777778;0.605;0.36;0.568;9;4;2;15
93;0.575714286;0.727;0.6825;0.668095238;7;10;4;21
192;0.651;0.591428571;0.625263158;0.625833333;10;7;19;36
173;0.745;0.61;0.656666667;0.705;6;1;3;10
248;;;0.98;0.98;0;0;11;11
85;0.523333333;0.661578947;0.65;0.609375;12;19;1;32
211;0.52;0.551666667;0.46;0.512142857;3;6;5;14
99;0.64625;0.605;0.8;0.6378125;16;14;2;32
215;0.668571429;0.614615385;0.534;0.6136;7;13;5;25
280;0.44;0.64;;0.54;2;2;0;4
277;0.75;0.782857143;0.7575;0.77;2;7;4;13
253;0.665714286;0.762;0.791428571;0.706969697;21;5;7;33
136;;0.78;0.776153846;0.776428571;0;1;13;14
77;;;;;0;0;0;0
38;;;0.98;0.98;0;0;1;1
205;0.75;0.703333333;0.575;0.645;1;3;4;8
19;0.57625;0.765;0.65;0.656666667;8;6;1;15
147;0.708;0.665;0.57;0.667272727;5;4;2;11
117;0.82;0.806666667;0.65;0.765714286;2;3;2;7
135;0.774285714;0.78;0.78;0.776923077;7;5;1;13
233;;;;;0;0;0;0
236;0.808333333;0.736666667;0.81;0.787;6;3;1;10
110;0.55;0.75;0.8675;0.805;1;9;12;22
130;0.98;0.98;0.49;0.931;4;5;1;10
261;0.647857143;0.56;0.65;0.622857143;14;6;1;21
39;0.848;0.736666667;0.87;0.816315789;10;6;3;19
160;0.598461538;0.599090909;0.56;0.586571429;13;11;11;35
251;0.578571429;0.682941176;0.606;0.644482759;7;17;5;29
124;0.651538462;0.590952381;0.623333333;0.6155;13;21;6;40
207;0.846666667;0.615;0.684285714;0.699285714;3;4;7;14
128;;0.98;;0.98;0;1;0;1
133;;0.75;;0.75;0;1;0;1
203;0.45;0.805;0.765;0.677777778;3;4;2;9
60;0.75;0.821538462;;0.816428571;1;13;0;14
269;;;0.55;0.55;0;0;1;1
72;0.73;0.88;0.98;0.950833333;1;1;10;12
74;0.78;0.76;;0.765;2;6;0;8
82;0.86;0.75;;0.805;2;2;0;4
79;0.55;0.865;;0.76;1;2;0;3
73;;0.884444444;;0.884444444;0;9;0;9
265;;0.43;0.81;0.556666667;0;2;1;3
86;0.55;0.59;;0.57;1;1;0;2
65;;0.72;0.635;0.663333333;0;1;2;3
191;0.6425;;0.575;0.62;4;0;2;6
59;0.597777778;0.865;0.93;0.722;9;2;4;15
242;;0.423636364;;0.423636364;0;11;0;11
177;0.57;0.61;0.563333333;0.58375;7;6;3;16
8;;;0.61;0.61;0;0;1;1
26;0.75;;0.48;0.705;5;0;1;6
250;;;0.55;0.55;0;0;1;1
155;;;;;0;0;0;0
102;;;;;0;0;0;0
153;;;0.98;0.98;0;0;1;1
17;;0.43;0.65;0.54;0;2;2;4
67;;0.55;0.44;0.495;0;1;1;2
243;;;;;0;0;0;0
260;;;;;0;0;0;0
185;;;0.65;0.65;0;0;2;2
213;0.815;;;0.815;2;0;0;2
